1111111111111111111111111111111111111111
1222222222222222222112222222222222222221
12C20002000200020C211202000200020002PE21
1202020202020202022222020002000200020021
1200020002000200000000000200020002000021
1220222222222222222202222222222222222221
112022C211111111111202221111111111111111
1120000211111111111200002111111111111111
12202222222222222222222C2222222222222221
1200200200020002000000020002020200020021
1202000202020202022222020202000200020021
1200020002000200002112000200020002000C21
1222222222222222222112222222222222222221
1111111111111111111111111111111111111111